{ 
  "1":{
    "node":[[0,4],[20,4],[22,4],[40,4],[0,0],[22,0],[40,0],[20,6],[18,6]],
    "adjacency":[
    [0, 1, 0, 0, 1, 0, 0, 0, 0],
    [1, 0, 1, 0, 0, 0, 0, 1, 0],
    [0, 1, 0, 1, 0, 1, 0, 0, 0],
    [0, 0, 1, 0, 0, 0, 1, 0, 0],
    [1, 0, 0, 0, 0, 1, 0, 0, 0],
    [0, 0, 1, 0, 1, 0, 1, 0, 0],
    [0, 0, 0, 1, 0, 1, 0, 0, 0],
    [0, 1, 0, 0, 0, 0, 0, 0, 1],
    [0, 0, 0, 0, 0, 0, 0, 1, 0]],
    "elevator_hall":[8],
    "elevator":[9],
    "MSE office":[1],
    "Creative Center":[4],
    "entrance":[]
  },
    "2":{
    "node":[[0,4],[20,4],[22,4],[40,4],[0,0],[22,0],[40,0],[20,6],[18,6]],
    "adjacency":[
    [0, 1, 0, 0, 1, 0, 0, 0, 0],
    [1, 0, 1, 0, 0, 0, 0, 1, 0],
    [0, 1, 0, 1, 0, 1, 0, 0, 0],
    [0, 0, 1, 0, 0, 0, 1, 0, 0],
    [1, 0, 0, 0, 0, 1, 0, 0, 0],
    [0, 0, 1, 0, 1, 0, 1, 0, 0],
    [0, 0, 0, 1, 0, 1, 0, 0, 0],
    [0, 1, 0, 0, 0, 0, 0, 0, 1],
    [0, 0, 0, 0, 0, 0, 0, 1, 0]],
    "elevator_hall":[8],
    "elevator":[9],
    "202":[5],
    "206":[6],
    "entrance":[]
  },
  "3":{
    "node":[[0,4],[20,4],[22,4],[40,4],[0,0],[22,0],[40,0],[20,6],[18,6]],
    "adjacency":[
    [0, 1, 0, 0, 1, 0, 0, 0, 0],
    [1, 0, 1, 0, 0, 0, 0, 1, 0],
    [0, 1, 0, 1, 0, 1, 0, 0, 0],
    [0, 0, 1, 0, 0, 0, 1, 0, 0],
    [1, 0, 0, 0, 0, 1, 0, 0, 0],
    [0, 0, 1, 0, 1, 0, 1, 0, 0],
    [0, 0, 0, 1, 0, 1, 0, 0, 0],
    [0, 1, 0, 0, 0, 0, 0, 0, 1],
    [0, 0, 0, 0, 0, 0, 0, 1, 0]],
    "elevator_hall":[8],
    "elevator":[9],
    "302":[5],
    "306":[6],
    "entrance":[]
  },
  "4":{
    "node":[[0,4],[20,4],[22,4],[40,4],[0,0],[22,0],[40,0],[20,6],[18,6]],
    "adjacency":[
    [0, 1, 0, 0, 1, 0, 0, 0, 0],
    [1, 0, 1, 0, 0, 0, 0, 1, 0],
    [0, 1, 0, 1, 0, 1, 0, 0, 0],
    [0, 0, 1, 0, 0, 0, 1, 0, 0],
    [1, 0, 0, 0, 0, 1, 0, 0, 0],
    [0, 0, 1, 0, 1, 0, 1, 0, 0],
    [0, 0, 0, 1, 0, 1, 0, 0, 0],
    [0, 1, 0, 0, 0, 0, 0, 0, 1],
    [0, 0, 0, 0, 0, 0, 0, 1, 0]],
    "elevator_hall":[8],
    "elevator":[9],
    "421":[1],
    "429":[4],
    "402":[5],
    "409":[7],
    "MSE-HUB":[6],
    "entrance":[]
  },
    "5":{
    "node":[[0,4],[20,4],[22,4],[40,4],[0,0],[22,0],[40,0],[20,6],[18,6]],
    "adjacency":[
    [0, 1, 0, 0, 1, 0, 0, 0, 0],
    [1, 0, 1, 0, 0, 0, 0, 1, 0],
    [0, 1, 0, 1, 0, 1, 0, 0, 0],
    [0, 0, 1, 0, 0, 0, 1, 0, 0],
    [1, 0, 0, 0, 0, 1, 0, 0, 0],
    [0, 0, 1, 0, 1, 0, 1, 0, 0],
    [0, 0, 0, 1, 0, 1, 0, 0, 0],
    [0, 1, 0, 0, 0, 0, 0, 0, 1],
    [0, 0, 0, 0, 0, 0, 0, 1, 0]],
    "elevator_hall":[8],
    "elevator":[9],
    "502":[5],
    "506":[6],
    "entrance":[]
  }
}